                    ☰                                                          
                    ☰                        t   t                             
      ☰█████████████ ██████████████████████████████████████☰████████████       
      ☰              █                                     ☰☰██        █       
      ☰              █                                        d        █       
      ☰                                                     ▞██▚bb 5 b █       
      ☰              █b 1╔╤╤╕2╔╤╤╤╤╤╤╤╤╤╕   ╔╤╤╤╤╤╤╤╤╤╤╤╕b ▞████████████       
      ☰          t t █████████████████████☰██████████████████▞         █       
      ☰         ██████       ▧▧           ☰   ☰                        █       
      ☰        ██            ▧▧           ☰    ☰                       █       
      ☰      t █             ▧▧     b   b ☰ b ☰  t t b b 3 b b b       █       
      ☰     ████             ▧▧    ███☰███☰███  █████████████████▚ b b █       
      ☰     ▧  ▧             ▧▧    ▧  ☰                          ███████       
           ▞███████▚     t   ▧▧    ▧  ☰          ‿ 4             ▧ ▧ ▧ ▧       
      ▞███████████████████████████████████████████████████████████████████▚    
███████████████████████████████████████████████████████████████████████████████
