                                                                               
                                                                               
                                                                               
                                                         f                     
                                                        ███████                
                                                        █     █                
                                                        █     ██               
                                                        █      ███             
                                                        █        █      f      
                                                        █        █ ███████     
    ████████████████████████████████████████████        █        █ █     █     
   ☰                                            ☰       █        █ █     █     
   ☰                             ⋇ ⋇ ⋇        f         ████☰█████ █     █     
      ⋇ ⋇ ⋇                     ▞██████⍾ ⍾██████▚       ████☰█████ █████☰█     
   ▞████████⍾ ⍾████████▚   t   ▞█████████████████▚  t   ▧▧▧▧▧▧▧▧▧▧▧▧▧▧▧▧▧▧     
███████████████████████████████████████████████████████████████████████████████
