                                                                               
                                                                               
                                                                               
                                                         🌷                     
                                                        ███████                
                                                        █     █                
                                                        █     ██               
                                                        █      ███             
                                                        █        █      🌷      
                                                        █        █ ███████     
    ████████████████████████████████████████████        █        █ █     █     
   ☰                                            ☰       █        █ █     █     
   ☰                             ⁂ ⁂ ⁂        🌷         ████☰█████ █     █     
      ⁂ ⁂ ⁂                     ▞██████⍾ ⍾██████▚       ████☰█████ █████☰█     
   ▞████████⍾ ⍾████████▚   🌲   ▞█████████████████▚  🌳   ▧▧▧▧▧▧▧▧▧▧▧▧▧▧▧▧▧▧     
███████████████████████████████████████████████████████████████████████████████
