                                                                               
                                                                               
                                                                               
                                                                               
                                                        ███████                
                                                        █     █                
                                                        █     ██               
                                                        █      ███             
                                                        █        █             
                                                        █        █ ███████     
    ████████████████████████████████████████████        █        █ █     █     
   ☰                                            ☰       █        █ █     █     
   ☰                             ⁂ ⁂ ⁂                  ████☰█████ █     █     
      ⁂ ⁂ ⁂                     ▞██████ ██████▚       ████☰█████ █████☰█     
  ▞████████ ████████▚   🌲   ▞█████████████████▚  🌳   ▧▧▧▧▧▧▧▧▧▧▧▧▧▧▧▧▧▧     
███████████████████████████████████████████████████████████████████████████████
