                                                                               
                                                                               
                                                                               
                                                                               
                   ██████████████████                                          
                   █                █                                          
                                    █                                          
                   █                                                           
                   █ 1  ☷ ☷   ☷ ☷ ☷ █                                          
                   ████☰█████████████                                          
                   ▧▧▧▧▧▧▧▧▧▧▧▧▧▧▧▧▧▧                                          
          ▞██████████████████████████████▔██████████████████████▚              
         ▞█                                                     █▚             
        ▞██                                                     ██▚            
       ▞███ ⌸  ⌸                             ⌸ ⌸ ⌸              ███▚           
███████████████████████████████████████████████████████████████████████████████
