                                                                               
                                                                               
                                                                               
                                                                               
                   ██████████████████                                          
                   █                █                                          
                   W                █                                          
                   █                W                                          
                   █ 1  ▤ ▤   ▤ ▤ ▤ █                                          
                   ████☰█████████████                                          
                   ▧▧▧▧▧▧▧▧▧▧▧▧▧▧▧▧▧▧                                          
          ▞██████████████████████████████2██████████████████████▚              
         ▞█                                                     █▚             
        ▞██                                                     ██▚            
       ▞███ ⌸  ⌸                             ⌸ ⌸ ⌸              ███▚           
███████████████████████████████████████████████████████████████████████████████
