                                                                               
                                                           ⛚⛛                  
                                                          ⛚  ⛛                 
                                                         ⛚    ⛛                
       ████████████████████████████████████             ⛚      ⛛               
       █                █                 █            ⛚        ⛛              
       █                █                 █           ⛚          ⛛             
       █                █                 █           ████████████             
       █                █       ⚘⚘ ⚘⚘ ⚘1⚘ █           █          █             
       █                █    ▞█████████████           █          █             
       W                █   ▞             W           W          █             
       █2⚘⚘   ⌸ ⚘⚘ ⚘ ⌸⌸ 🚪  ▞              █           █          █             
       █████☰██████████████████████████████           █   3      █             
       █████☰██████████████████████████████           ████████☰███             
       ▧▧▧▧▧▧▧▧▧▧▧▧▧▧▧▧▧▧▧▧▧▧▧▧▧▧▧▧▧▧▧▧▧▧▧▧           ▧▧▧▧▧▧▧▧▧▧▧▧             
███████████████████████████████████████████████████████████████████████████████
