                                                                               
                                                                               
                                                                               
                                                                               
       █║██████████████████████████████████████████████████████████████        
       █║               █                 █                           █        
       █║               █                 █              ⚬  ⚬         █        
       █║               █                 █          ██████████████████        
        ║               █                 █                                    
       █⚞   1   ⌸       🚪      ⚬ ⌸ ⚭      🚪                           █        
       █████☰███████████████████████████████████████▚  CC CCCC  CC CCC█        
       █    ☰                                       ▚██████████████████        
       █  🌷 ☰ 🌷  ⌸ ⌸                      ⚘ ⚘ 🌷                   █            
       █████☰██████████████████████████████████████████████████████   █        
  3 4 5▧6▧▧▧▧▧▧▧▧▧▧▧▧▧▧▧▧ ▧▧▧ ⌸ ▧▧▧▧▧ ▧▧▧▧ ▧▧▧▧▧▧ ▧▧▧▧▧▧▧▧▧ ▧▧▧▧▧▧▧  ███2      
██████████████████████████████████████████████████████████████████████████⏖⏖⏖⏖⏖
