                                                                               
                                                                               
                                                                               
                                                                               
       █⧚██████████████████████████████████████████████████████████████        
       █⧚               █                 █                           █        
       █⧚               █                 █              b  b         █        
       █⧚               █                 █          ██████████████████        
        ⧚               ▐                 ▐                                    
       █⩟   1   ⌸       d      b ⌸ b      d                           █        
       █████☰███████████████████████████████████████▚  ◨◩ ◨◨◪◩  ◪◧ ◩◨◪█        
       █    ☰                                       ▚██████████████████        
       █  t ☰ t  ⌸ ⌸                      ⍑ ⍑ t                   █            
       █████☰██████████████████████████████████████████████████████   █        
  3 4 5▧6▧▧▧▧▧▧▧▧▧▧▧▧▧▧▧▧ ▧▧▧ ⌸ ▧▧▧▧▧ ▧▧▧▧ ▧▧▧▧▧▧ ▧▧▧▧▧▧▧▧▧ ▧▧▧▧▧▧▧  ███2      
██████████████████████████████████████████████████████████████████████████⏖⏖⏖⏖⏖
