                                                                               
            █                                                                  
            █                          ████████████████████████████            
            █   ████████████████                                   ☰           
            █                   ☰                                  ☰           
            █              ████████                    ███████████████         
            █       █              ☰                  ☰                        
            █       █        █████████                ☰                        
            █       █          1      ☰             ██████████▚                
            ██████  █          ████████            ☰           ▚               
                    █                            █████████      ▚              
                                                ☰                ▚             
                █████████                      ████████           ▚            
                                              ☰                    ▚           
                      ███████████████████████████                   ▚     2    
                                                                     ██████████
