                                                                               
                                                                               
                ████████████████                                               
                █              █                        █████████████████████  
                █              ███████████              █                   █  
      ╱╲        █                        ████████████████                   █  
     ╱  ╲       █                                                           █  
    ╱    ╲      █                                                           █  
   ╱      ╲     █                                 8  9      ⌸               █  
  ╱        ╲    █                         ▞███3█████████4███████            █  
  ██████████    █                        ▞                                  █  
  █   █    █    █                7      ▞                                   █  
  █1 2     █    █           ▞████████████████☰                              █  
  ██████☰███    █          ▞                 ☰                              █  
  ▧▧▧ ▧▧▧▧▧▧    5    6    ▞                  ☰                              🚪  
████████☰████████████████████████████████████☰█████████████████████████████████
