                                                                               
                                                                               
                ████████████████                                               
                █              █                        █████████████████████  
                █              ███████████              █                   █  
      ⛚⛛        W                        ████████████████                   W  
     ⛚  ⛛       W                                                           W  
    ⛚    ⛛      █                                                           █  
   ⛚      ⛛     █                                 8  9      ⌸               █  
  ⛚        ⛛    █                         ▞███3█████████4███████            █  
  ██████████    █                        ▞                                  █  
  W   █    W    █                7      ▞                                   █  
  █1 2     █    █           ▞████████████████☰                              █  
  ██████☰███    █          ▞                 ☰                              █  
  ▧▧▧ ▧▧▧▧▧▧    5    6    ▞                  ☰                              🚪  
████████☰████████████████████████████████████☰█████████████████████████████████
