                                                                               
                                                                               
                                                                               
                                                                █              
                                                               ⛠ ⛡             
                                                 ⛠⛡           ⛠   ⛡            
                                                ⛠  ⛡         ⛠     ⛡           
                                               ⛠    ⛡        ███████           
                                               ██████        █     █           
                                               █    █        █     █           
                                               █    █        █     ┃           
                                               █   ⌸█        █ 2  ⌸█           
                                               ██☰███        ████☰██           
                                               ▧▧▧▧▧▧        ▧▧▧▧▧▧▧           
           9  █     █     █              ▞███████████████☰█████████████████████
7⏖⏖⏖⏖⏖⏖⏖8████████████████████████████████████████████████☰█████████████████████
