        ☰                                    ☰                                 
        ☰                                    ☰                                 
        ☰     ██  ██████        ██████       ☰                                 
        ☰     ██  █    █        █    █       ☰                                 
              ██  █  ▭ █        █    █████   ☰                                 
    ☰██████████████    █    █████        █                                     
    ☰                  ██████            ████████▚                             
    ☰                                             ▚                            
    ██████▚          ▭      ▭              ▭       ▚                           
           ▚                       ▭                ▚                          
            ▚     ▭                           ▭      █████                     
             ▚               ▭         ▭                  ☰                    
              ▚                                                                
               ████████████████████████████████████████████                    
            ███████                                     ███                    
███████████████████████████████████████████████████████████████████████████████
