                                                                               
                                                                               
                                                                               
                                                                █              
                                                               / \             
                                                 /\           /   \            
                                                /  \         /     \           
                                               /    \        ███████           
                                               ██████        █     █           
                                               █    █        █     █           
                                               █    █        █                 
                                               █   ⌸█        █ 2  ⌸█           
                                               ██☰███        ████☰██           
                                               ▧▧▧▧▧▧        ▧▧▧▧▧▧▧           
           9  █     █     █              ▞███████████████☰█████████████████████
⏖⏖⏖⏖⏖⏖⏖⏖8████████████████████████████████████████████████☰█████████████████████
