                                                                               
                                                                               
                                                                               
                                                                █              
                                                               ⛚ ⛛             
                                                 ⛚⛛           ⛚   ⛛            
                                                ⛚  ⛛         ⛚     ⛛           
                                               ⛚    ⛛        ███████           
                                               ██████        █     █           
                                               █    █        █     █           
                                               █    █        █     W           
                                               █   ⌸█        █ 2  ⌸█           
                                               ██☰███        ████☰██           
                                               ▧▧▧▧▧▧        ▧▧▧▧▧▧▧           
           9  █     █     █              ▞███████████████☰█████████████████████
⏖⏖⏖⏖⏖⏖⏖⏖8████████████████████████████████████████████████☰█████████████████████
