






       ████████████████████████████████████████████████████████████████
       █                █                 █                           █
       █                █                 █                           █
       █                █                 █                           █
                        ▐                 ▐                            
       █                🚪                🚪                          █
       █████☰██████████████████████████████████████████████████████████
            ☰
            ☰
            ☰
 💚  💚     ☰
███████████████████████████████████████████████████████████████████████████████
