                          /\            /\                                     
                         /  \          /  \                                    
                        /    \        /    \                                   
                       /      \      /      \                                  
                      /        \    /        \                                 
                     /          \  /          \                                
                    /            \/            \⌸🌷                             
                    ███████████████████████████████                            
                    █                             █                            
                    █                             █                            
                    █                             █                            
                    █                             █                            
                    █ ⌸                         ⌸ █                            
                    ███████☰██████████████☰████████                            
  ⍾     8 9         ▧▧▧▧▧▧▧▧▧▧▧▧▧▧▧▧▧▧▧▧▧▧▧▧▧▧▧▧▧▧▧                        ⌸⌸  
███████████████████████████████████████████████████████████████████████████████
