                          ╱╲            ╱╲                                     
                         ╱  ╲          ╱  ╲                                    
                        ╱    ╲        ╱    ╲                                   
                       ╱      ╲      ╱      ╲                                  
                      ╱        ╲    ╱        ╲                                 
                     ╱          ╲  ╱          ╲                                
                    ╱            ╲╱            ╲⌸🌷                             
                    ███████████████████████████████                            
                    █                             █                            
                    █                             █                            
                    █                             █                            
                    █                             █                            
                    █ ⌸                         ⌸ █                            
                    ███████☰██████████████☰████████                            
  ⍾     8 9         ▧▧▧▧▧▧▧▧▧▧▧▧▧▧▧▧▧▧▧▧▧▧▧▧▧▧▧▧▧▧▧                        ⌸⌸  
███████████████████████████████████████████████████████████████████████████████
