                          /\            /\                                     
                         /  \          /  \                                    
                        /    \        /    \                                   
                       /      \      /      \                                  
                      /        \    /        \                                 
                     /          \  /          \                                
                    /            \/            \⌸                              
                    ███████████████████████████████                            
                    █                             █                            
                    █                             █                            
                    W                             █                            
                    █                             W                            
                    █ ⌸                         ⌸ █                            
                    ███████☰██████████████☰████████                            
       8 9         ▧▧▧▧▧▧▧▧▧▧▧▧▧▧▧▧▧▧▧▧▧▧▧▧▧▧▧▧▧▧▧                        ⌸⌸  
███████████████████████████████████████████████████████████████████████████████
