                                       █████ ███                               
                           █                                  █                
      ████████████████████ █                                  █ ███████████████
                           █                                  █                
               █           █                         1    2   █        █       
               █           █  ██████████████████████████████  █        █       
               █           █                                  █        █       
               █           ████████████████████████████████████        █       
               █                                                       █       
               █  ███████████████████████████████████████████████████  █       
               █                                                       █       
               █                  █████████████████████                █       
               █ █████████████████████████████████████████████████████ █       
               █ █████████████████████████████████████████████████████ █       
               █                                                       █       
               █                                                       █       
