                                                                               
                              ☰█         █                                     
                              ☰█☰█████████                                     
                              ☰█☰        █                                     
                              ☰█☰        █                                     
                              ☰█☰☰  ⎺ ⎺ ⎺█                                     
                              ☰█  ⎺      █                                     
                              ☰█   ☰ ⎺⎺  █                                     
                              ☰█ ⎺ ☰⎺   ⎺█                                     
                              ☰█  ⎺  ⎺   █                                     
                              ☰█     ⎺☰  █                                     
                              ☰█⎺⎺    ☰ ⎺█                                     
                              ☰█      1  █                                     
                              ☰█⏖⏖⏖⏖⏖⏖█⎺ █                                     
  8 9                         ☰█⏖⏖⏖⏖⏖⏖█  █                                     
███████████████████████████████████████████████████████████████████████████████
